Coordinates: 5:1	Type: Keyword	Source Code: program	Value: "program"
Coordinates: 5:9	Type: Identifier	Source Code: Hello	Value: "Hello"
Coordinates: 5:14	Type: Separator	Source Code: ;	Value: ";"
Coordinates: 6:1	Type: Keyword	Source Code: var	Value: "var"
Coordinates: 6:5	Type: Identifier	Source Code: a	Value: "a"
Coordinates: 6:6	Type: Separator	Source Code: ,	Value: ","
Coordinates: 6:7	Type: Identifier	Source Code: b	Value: "b"
Coordinates: 6:8	Type: Separator	Source Code: ,	Value: ","
Coordinates: 6:9	Type: Identifier	Source Code: c	Value: "c"
Coordinates: 6:10	Type: Separator	Source Code: :	Value: ":"
Coordinates: 6:11	Type: Keyword	Source Code: integer	Value: "integer"
Coordinates: 6:18	Type: Separator	Source Code: ;	Value: ";"
Coordinates: 8:5	Type: Identifier	Source Code: f	Value: "f"
Coordinates: 8:7	Type: Separator	Source Code: :	Value: ":"
Coordinates: 8:9	Type: Keyword	Source Code: real	Value: "real"
Coordinates: 8:13	Type: Separator	Source Code: ;	Value: ";"
Coordinates: 9:1	Type: Keyword	Source Code: begin	Value: "begin"
Coordinates: 10:3	Type: Identifier	Source Code: writeln	Value: "writeln"
Coordinates: 10:10	Type: Separator	Source Code: (	Value: "("
Coordinates: 10:11	Type: Identifier	Source Code: a	Value: "a"
Coordinates: 10:12	Type: Separator	Source Code: )	Value: ")"
Coordinates: 10:13	Type: Separator	Source Code: ;	Value: ";"
Coordinates: 11:1	Type: Keyword	Source Code: end.	Value: "end."